 = {
	provinces = {
		4 12 14 29 34 41 91 108 109 123 126 156 172 184 194 198 206 223 247 277 299 312 319 321 325 336 342 347 348 378 384 411 416 440 441 448 483 491 496 505 534 598 608 613 620 675 691 703 708 710 719 720 726 752 757 771 778 785 812 814 831 833 869 877 878 901 904 906 912 915 997 998 999 1019 1046 1048 1053 1070 1092 1093 1096 1102 1131 1137 1155 1158 1179 1184 1215 1231 1232 1250 1275 1282 1286 1320 1321 1325 1336 1346 1347 1355 1361 
	}
	assimilation_rate = 0.01
}
 = {
	provinces = {
		8 15 30 70 92 101 106 139 143 160 161 162 186 187 201 213 217 218 233 236 250 256 260 264 282 296 309 314 354 370 375 380 381 392 399 407 418 424 427 458 460 464 469 481 484 490 493 494 497 508 510 524 536 543 568 582 586 588 614 621 641 650 653 654 657 723 732 763 774 803 825 826 830 847 852 879 884 892 900 902 927 941 944 948 951 957 972 990 1013 1031 1049 1059 1063 1107 1112 1117 1125 1126 1133 1134 1154 1161 1163 1165 1171 1176 1196 1198 1199 1209 1223 1230 1243 1261 1280 1292 1299 1338 1351 
	}
	assimilation_rate = 0.01
}
 = {
	provinces = {
		6 11 18 23 25 37 44 49 55 56 57 59 74 82 83 99 102 113 144 157 164 177 179 181 193 195 199 202 219 224 242 245 252 270 271 286 289 302 305 308 316 320 326 332 353 355 358 385 389 410 422 423 446 450 453 488 501 506 512 513 515 526 528 540 542 553 565 573 577 578 579 583 591 593 599 605 619 625 626 627 630 646 647 652 666 667 672 682 692 706 707 718 727 742 744 749 753 754 766 787 788 791 801 806 809 810 823 836 840 842 848 855 858 863 865 866 867 872 888 926 929 931 937 942 956 969 979 993 1012 1014 1018 1040 1044 1047 1052 1054 1066 1068 1089 1105 1108 1109 1130 1135 1145 1147 1152 1159 1164 1169 1188 1195 1197 1210 1214 1217 1233 1242 1244 1256 1260 1273 1283 1287 1288 1297 1324 1326 1330 1359 
	}
	assimilation_rate = 0.01
}
 = {
	provinces = {
		3 13 22 27 33 45 48 53 58 62 63 64 66 68 69 77 90 93 94 96 98 105 110 111 112 115 117 119 120 130 131 132 135 137 138 155 167 168 169 170 171 175 188 190 191 196 204 209 211 220 222 228 232 238 239 240 244 246 249 258 261 267 269 272 278 283 284 285 288 291 306 315 322 329 333 334 337 340 341 345 360 362 364 390 395 414 415 419 431 432 436 438 439 443 444 447 449 451 454 466 468 472 473 475 476 477 498 504 519 520 529 535 537 541 548 551 552 557 559 560 562 572 574 575 576 581 592 595 597 602 603 604 606 612 622 628 632 639 640 642 644 658 660 662 663 664 670 676 680 681 684 694 697 705 712 714 728 729 731 735 736 739 741 745 748 755 768 772 775 780 783 784 789 790 793 796 797 800 802 811 821 822 824 829 837 839 849 851 853 862 871 874 875 880 883 887 890 891 911 916 919 921 923 928 930 938 950 955 964 966 973 974 975 978 982 989 991 992 1000 1002 1010 1011 1015 1016 1020 1021 1027 1034 1035 1038 1050 1051 1055 1057 1058 1067 1071 1073 1075 1078 1080 1081 1085 1088 1091 1095 1099 1104 1106 1115 1119 1120 1121 1132 1136 1141 1143 1160 1162 1166 1173 1181 1182 1185 1190 1191 1193 1201 1202 1204 1205 1208 1212 1213 1219 1220 1224 1227 1228 1235 1237 1253 1254 1262 1269 1274 1277 1279 1290 1291 1293 1294 1295 1298 1302 1304 1312 1334 1337 1339 1345 1349 1350 1353 1356 1357 
	}
	assimilation_rate = 0.01
}
 = {
	provinces = {
		0 1 2 5 7 9 10 16 17 19 20 21 24 26 28 31 32 35 36 38 39 40 42 43 46 47 50 51 52 54 60 61 65 67 71 72 73 75 76 78 79 80 81 84 85 86 87 88 89 95 97 100 103 104 107 114 116 118 121 122 124 125 127 128 129 133 134 136 140 141 142 145 146 147 148 149 150 151 152 153 154 158 159 163 165 166 173 174 176 178 180 182 183 185 189 192 197 200 203 205 207 208 210 212 214 215 216 221 225 226 227 229 230 231 234 235 237 241 243 248 251 253 254 255 257 259 262 263 265 266 268 273 274 275 276 279 280 281 287 290 292 293 294 295 297 298 300 301 303 304 307 310 311 313 317 318 323 324 327 328 330 331 335 338 339 343 344 346 349 350 351 352 356 357 359 361 363 365 366 367 368 369 371 372 373 374 376 377 379 382 383 386 387 388 391 393 394 396 397 398 400 401 402 403 404 405 406 408 409 412 413 417 420 421 425 426 428 429 430 433 434 435 437 442 445 452 455 456 457 459 461 462 463 465 467 470 471 474 478 479 480 482 485 486 487 489 492 495 499 500 502 503 507 509 511 514 516 517 518 521 522 523 525 527 530 531 532 533 538 539 544 545 546 547 549 550 554 555 556 558 561 563 564 566 567 569 570 571 580 584 585 587 589 590 594 596 600 601 607 609 610 611 615 616 617 618 623 624 629 631 633 634 635 636 637 638 643 645 648 649 651 655 656 659 661 665 668 669 671 673 674 677 678 679 683 685 686 687 688 689 690 693 695 696 698 699 700 701 702 704 709 711 713 715 716 717 721 722 724 725 730 733 734 737 738 740 743 746 747 750 751 756 758 759 760 761 762 764 765 767 769 770 773 776 777 779 781 782 786 792 794 795 798 799 804 805 807 808 813 815 816 817 818 819 820 827 828 832 834 835 838 841 843 844 845 846 850 854 856 857 859 860 861 864 868 870 873 876 881 882 885 886 889 893 894 895 896 897 898 899 903 905 907 908 909 910 913 914 917 918 920 922 924 925 932 933 934 935 936 939 940 943 945 946 947 949 952 953 954 958 959 960 961 962 963 965 967 968 970 971 976 977 980 981 983 984 985 986 987 988 994 995 996 1001 1003 1004 1005 1006 1007 1008 1009 1017 1022 1023 1024 1025 1026 1028 1029 1030 1032 1033 1036 1037 1039 1041 1042 1043 1045 1056 1060 1061 1062 1064 1065 1069 1072 1074 1076 1077 1079 1082 1083 1084 1086 1087 1090 1094 1097 1098 1100 1101 1103 1110 1111 1113 1114 1116 1118 1122 1123 1124 1127 1128 1129 1138 1139 1140 1142 1144 1146 1148 1149 1150 1151 1153 1156 1157 1167 1168 1170 1172 1174 1175 1177 1178 1180 1183 1186 1187 1189 1192 1194 1200 1203 1206 1207 1211 1216 1218 1221 1222 1225 1226 1229 1234 1236 1238 1239 1240 1241 1245 1246 1247 1248 1249 1251 1252 1255 1257 1258 1259 1263 1264 1265 1266 1267 1268 1270 1271 1272 1276 1278 1281 1284 1285 1289 1296 1300 1301 1303 1305 1306 1307 1308 1309 1310 1311 1313 1314 1315 1316 1317 1318 1319 1322 1323 1327 1328 1329 1331 1332 1333 1335 1340 1341 1342 1343 1344 1348 1352 1354 1358 1360 1362 1363 1364 1365 1366 
	}
	assimilation_rate = 0.01
}
